02 14 12 04 06 10 10 12
02 09 03 15 11 14 08 05
06 12 06 15 10 09 00 05
05 07 11 15 10 12 04 05
07 11 12 07 08 03 09 05
03 12 03 09 06 10 14 09
02 09 00 00 01 02 11 12
00 00 00 00 00 00 00 01
